R 1000 720

NO ./textures/grey.xpm
SO ./textures/hitler.xpm
EA ./textures/banner.xpm
WE ./textures/eagle.xpm

S ./textures/chest.xpm

F ./textures/floor.xpm
C ./textures/milkyway.xpm

11111111111111111111111111111
10000000001100000000000000001
10110000011100000000000010001
102000000000000000000W0000001
10110000011100000000000010001
10000000001100000111011110001
11110110111111011100000010001
11110111111111011101010000001
11000000110101011000000000001
10000000000000000000000000001
10000000000000001101010010001
11000000110101011111011110001
11101111111101011111011110001
11111111111111111111111111111
