R 123123 516464

NO ./textures/brick.xpm
SO ./textures/blue.xpm
WE ./textures/wood.xpm
EA ./textures/grey.xpm

S ./textures/barrel.xpm
F 100,0,100
C 205,249,255


111111111111111
100000000000101
100101200000101
101110200010101
100000000010101
100000001111101
100000000000001
100000000000001
1111110N0111101
100000000000001
111111111111111