R 123123 516464

NO ./textures/brick.xpm
SO ./textures/blue.xpm
WE ./textures/wood.xpm
EA ./textures/grey.xpm

S ./textures/barrel.xpm
F 100,0,100
C 205,249,255


111111111111111
1200000S0000101
100101000000101
101110000010101
100000200010101
100000001111101
100000000000001
100000220000001
111111000111101
100000000000001
111111111111111