R 123123 516464

NO ./textures/brick.xpm
SO ./textures/blue.xpm
WE ./textures/wood.xpm
EA ./textures/grey.xpm

S ./textures/barrel.xpm
F 100,0,100
C 0,0,0

11111111111111111111111111111
1222222222222W222222222222211
11111111111111111111111111111