R 1920 1080

NO ./textures/brick.xpm
SO ./textures/blue.xpm
WE ./textures/wood.xpm
EA ./textures/grey.xpm

S ./textures/barrel.xpm
F 100,0,100
C 205,249,255

            11111111111111 11111111111111
            10000000001101 10000000000001
            10000000011101110200000000101
            1E002020202000000000000010001
            10000000011100000111111111111
11111111111100001111011110001
11110111111111011100000010001
11110111111111011101010000001
11000000110101011000000000001
10000000000000000000000000001
10000000000000001101010010001
11000000110101011111011110001
11110111111101011111011110001
11111111111111111111111111111
