R 123123 516464

NO ./textures/brick.xpm
SO ./textures/blue.xpm
WE ./textures/wood.xpm
EA ./textures/grey.xpm

S ./textures/barrel.xpm
F 100,0,100
C 205,249,255

11111111111111111111111111111
10000000001100000000000000001
10110000011100020000000010001
101000000000000000000W0010001
10110000011100000000000010001
10000000001100000111011110001
11110111111111011100000010001
11110111111111011101010000001
11000000110101011000000000001
10000000000000N00000000000001
10000000000000001101010010001
11000000110101011111011110001
11110111111101011111011110001
11111111111111111111111111111

11111111111111111111111111111
1222222222222W222222222222211
11111111111111111111111111111