R 1000 1000

NO ./textures/brick.xpm
SO ./textures/blue.xpm
WE ./textures/wood.xpm
EA ./textures/grey.xpm

S ./textures/chest.xpm
F 224,172,105
C 205,249,255

11111111111111111111111111111
1222222222222W222222222222211
11111111111111111111111111111