R 1080 720
NO ./textures/brick.xpm
SO ./textures/blue.xpm
WE ./textures/wood.xpm
EA ./textures/grey.xpm

S ./textures/chalice.xpm
F 224,172,105
C 205,249,255

11111111111111111
10000000000000001
10020000000000001
10000000000000001
10000000002000001
10000200000000001
10000000000000001
10000000000000001
10000000000000001
10000000N00000001
10000000000000001
11111111111111111
